R   1024 640
WE textures/wood.xpm

NO textures/greystone.xpm
  SO              textures/mossy.xpm
   EA  textures/redbrick.xpm
S    textures/barrel.xpm

F         250,100,39
C        51,30,40



                                                        11111111111111
                11111111111111111                       11000000000001
                100000000000000011111111111111111111111111020020020001
                10000000S000000000000000000000000000000000000000000001
                100000000000000011111111111111111001111111111111011111
                10000000000000001               1001           101
                10000000200000001               1001           101111111111111111
                10000000000000001               1001           100000000000000001
                10000000200000001           111110011111       111111111111111101
                10000000000000001           100000000001                      101
                10000000200000001           100000000001                      101
                10000000000000001111111111111000200200011111111111111111111111101
                10000000000000000000000000000000000000000000000000000000000000001
                11111011111111111111111111111000200200011111111111111111111111101
                    101                     100000000001                      101
                11111011111111111           100000000001                      101
                10000000000000001           111110011111                      101
                10200000200000201               1001                          101
                10000000000000001111111111111111100111111111111111111111111111101
                10002000200020000000000000000000000000000000000000000000000000001
                10000000000000001111111111111111111111111111111111111111111111111
                10202020002020201
                10000000000000001
                10002000200200001
                10000000000000001
                10200000200002001111111111111
                10000000000000000000000000001
                11111111111111111111111111101
                                         11011
                                        11000111111111
11111111111111111                       11000000000001
100000000000000011111111111111111111111111020020020021
102000002000002000000000000000000000000000000000000001
100000000000000011111111111111111001111111111111011111
10002000200020001               1001           101
10000000000000001               1001           101111111111111111            11111111111111111111111111111
10202020002020201               1001           100000000000000001            10000000000000000000000000001
10000000000000001           111110011111       111111111111111101            10000000000000000000000000001
10002000200200001           100000000001                      101            10000000000000000000000000001
10000000000000001           100000000001                      101            11111111111101111111111111111
10200000200002001111111111111000200200011111111111111111111111101111111111111111111111111011111111111111111111111111111111111111111111111111111111111111111111111111111
10000000000000000000000000000000000000000000000000000000000000000000000000000000000000000000000000000000000000000000000000000000000000000000000000000000000000000000001
11111011111111111111111111111000200200011111111111111111111111101111111111111111111111111111111111111111111111111111111111111111111111111111111111111111111111111111111
    101                     100000000001                      101
11111011111111111           100000000001                      101
10000000000000001           111110011111                      101
10200000200000201               1001                          101
10000000000000001111111111111111100111111111111111111111111111101
10002000200020000000000000000000000000000000000000000000000000001
10000000000000001111111111111111111111111111111111111111111111111
10202020002020201
10000000000000001
10002000200200001
10000000000000001
10200000200002001
10000000000000001
11111111111111111