



  R    1024    640



NO textures/greystone.xpm
SO textures/mossy.xpm
WE textures/colorstone.xpm
EA textures/bluestone.xpm

S textures/barrel.xpm


F    184,113,39
C         51,198,227

      111111111111111111111111111
       10000000011000000000000001
        1011000001110000000000001
        10010000000000002000000W1
111111111011000001110000000000001
100000000011000001110011111111111
11110111111111011100000010001
111101111111110111010100100011111
1000000011010101110000001000000001
1000000000000000110000001000011111
10000000000000000001010000001
110000011101010111110111100001111
11100111 1110101 11111111000001
111111111 1111111 111111111111