
C         51,198,227

R      1024  640
WE textures/wood.xpm

NO textures/redbrick.xpm
  SO              textures/bluestone.xpm
   EA  textures/mossy.xpm
S textures/barrel.xpm

F       184,113,39

        1111111111111111111111111111111111
        1000000000110000000000000000000001
        1011000001110000000000000000000001
        1001000E00000000000000000000000001
111111111011000001110000020200000000000001
100000000011000001111111110111111111111111
11110111111111011122222210001
11110111111111011122222210001
11000000112121011122222210201
100020000000000011222222002001
10000000000000001122222210201
1100000111212121111111111000111
11110111 1111111 111111110001
11111111 1111111 11111111111 